NO ./images/brick1.png


F 0,100,0
WE       ./images/brick3.png
EA    ./images/brick4.png
SO ./images/brick2.png
C 225,30,0

111111
100101
101N01
110101
111111